Vera Maria	Cardiologia	3
Marco Infante	Pediatria	2
Mariana Loreto	Dermatologia	1
Carla Pratas	Fisioterapia	4
Filipa Mateus	Psicologia	3
Olivia Marques	Psicologia	2
Paulo Fernandes	Oftalm8ologia	1
Manuel Martins	Cardiologia	1
Bernardo Mendes	Estomatologia	3
Bianca Damas	Estomatologia	2
Carlota Menezes	Ortopedia	1
Miguel Loreto	Ortopedia	3
Carmo Felicidade	Oftalmologia	2
linha 14 - Teste da linha super hiper mega comprida, vou continuar a escrever imenso para testar isto.	Especialidade especial de medicina comprida	12345678901234567890
Maria Pinheiro	Ortopedia	4
Ana Rita Rodrigues	Pediatria	4	yryry	reuru
Mariana Marques	Oftalmologia	3
Rita Fonseca	Dermatologia	2
Marisa Fernandes	Ginecologia	1
Daniel Pimenta	Fisioterapia	1
Martim Braz	Ginecologia	2
Juliana Gomes	Neurologia	1
Artur Ribeiro	Neurologia	3
Adriana Pinto	Pediatria	4
Liliana Lopes	Cardiologia	2
Cristiano Ronaldo	Fisioterapia	1
Telmo Almeida	Psicologia	2
Diogo Guerreiro	Fisioterapia	3
Hugo Guerreiro	Neurologia	4
Carla Silva	Cardiologia	2
Ivo Faria	Cardiologia	1
Henrique Silva	Ortopedia	1
Sofia Santos	Estomatologia	3
Bruna Vanessa	Psicologia	4
Joel Fideles	Cardiologia	2
Ivone Costa	Pediatria	1
Oscar Lemos	Psiquiatria	3
Vanessa Lucas	Dermatologia	2
Edgar Morais	Ortodoncia	3
Joaquim Barreiros	Ortodoncia	1
Rodrigo Gedes	Ortodoncia	2
Rafael Amaral	Neurologia	1
Pilar Teles	Fisioterapia	3
Helena Moura	Pediatria	1
Joana Coelho	Estomatologia	1
Nuno Alexandre	Fisioterapia	3
Beatriz Fernandes	Oftalmologia	4
Rafael Farelo	Dermatologia	1
David Ventura	Psicologia	2
Pedro Rodrigues	Neurologia	1
Gabriel Neves	Ortopedia	3
Ricardo Cardoso	Estomatologia	5
Salvador Arieiro	Cardiologia	2
Mariana Alves	Psiquiatria	1
Tatiana Ramos	Psicologia	3
Madalena Silva	Cardiologia	4
Samuel Capela	Psicologia	2
Hugo Cabral	Psicologia	1
Tiago Meira	Ortodoncia	2
Brigite Miranda	Oftalmologia	3
Lucas Vieira	Estomatologia	3
Joana Antunes	Pediatria	1
Maria Parreira	Neurologia	2
Bernardo Varandas	Fisioterapia	1
Rafaela Severa	Cardiologia	2
Rita Cunha	Ortopedia	1
Alexandre Serra	Estomatologia	2
Daniel Mariano	Psiquiatria	1
Pedro Mendes	Oftalmologia	2
Mara Cardoso	Dermatologia	1
Carolina Bandeira	Cardiologia	1
Olga Abreu	Psiquiatria	2
Catarina Rabuge	Psicologia	1
Maria do Carmo Leite	Neurologia	3
Diniz Ferreira	Cardiologia	4
Guilherme Melo	Ortodoncia	3
Bruno Aleixo	Psicologia	4
Joaquina Baptista	Estomatologia	1
Tiago Garzia	Oftalmologia	3
Ulisses Cordeiro	Pediatria	2
Renato Carneiro	Ortopedia	1
Renata Cunha	Ginecologia	2
Dylan Castro	Fisioterapia	2
Eduardo Machado	Dermatologia	1
Isabel Roseiro	Neurologia	2
Gina Gaspar	Psicologia	3
Leonor Almeida	Psiquiatria	4
Leandro Neves	Cardiologia	1
Fausto Arzileiro	Neurologia	2
Ariana Mangas	Dermatologia	1
Vasco Coimbra	Psicologia	2
Xavier Amorim	Ortodoncia	1
Lia Botelho	Oftalmologia	2
Eva Torres	Ortopedia	1
Ricardo Figueiredo	Cardiologia	2
Dante Armas	Fisoterapia	1
Mikael Rua	Oftalmologia	2
Marta Andrade	Fisioterapia	3
Marisa Mendes	Dermatologia	3
Danila Vilas	Fisioterapia	1
Olimpia Brito	Cardiologia	2
Gustavo Costa	Psicologia	1
Ambar Celeste	Psiquiatria	3
Clarissa Francisca	Pediatria	4
